1
0	0	0	0	0	0	0	0	0	0	0	0	0	0	
0	0	0	0	0	0	0	0	0	0	0	100	0	0	
0	0	0	10	0	0	12	0	0	0	0	0	0	0	
0	0	10	0	0	0	16	0	0	40	0	0	0	0	
0	0	0	0	0	0	0	0	0	16	24	0	0	0	
0	0	0	0	0	0	0	0	0	32	0	0	0	0	
0	0	12	16	0	0	0	12	0	0	0	0	0	0	
0	0	0	0	0	0	12	0	24	56	0	0	0	0	
0	0	0	0	0	0	0	24	0	0	0	20	0	0	
0	0	0	40	16	32	0	56	0	0	125	0	80	0	
0	0	0	0	24	0	0	0	0	125	0	60	40	0	
0	100	0	0	0	0	0	0	20	0	60	0	0	0	
0	0	0	0	0	0	0	0	0	80	40	0	0	90	
0	0	0	0	0	0	0	0	0	0	0	0	90	0	
