1
0	0	0	0	0	0	0	0	0	0	0	0	
0	0	50	0	0	60	0	0	0	0	0	0	
0	50	0	80	0	80	0	0	40	0	0	0	
0	0	80	0	20	0	0	0	0	0	0	0	
0	0	0	20	0	0	0	0	160	0	0	0	
0	60	80	0	0	0	60	0	0	0	0	0	
0	0	0	0	0	60	0	120	280	0	0	0	
0	0	0	0	0	0	120	0	0	0	100	0	
0	0	40	0	160	0	280	0	0	500	0	400	
0	0	0	0	0	0	0	0	500	0	300	200	
0	0	0	0	0	0	0	100	0	300	0	0	
0	0	0	0	0	0	0	0	400	200	0	0	
